11111111
1C0000E1
10P0C0C1
11111111
